WWWWWWWWWWWWWWWWWWWWWWWWWWWWWWWWWWWWWWWWWWWWWWWWWWWWWWWWWWWWWWW
WFFFFFFFFFFFFWFFFFFFFFFFFFFFFFFFFFFFFFFFFFFFFFFFFFFFFFFFFFFFFFW
WFFTFFFFFFFFFWFFFFFFFFFFFFFFFFFFFFFFFFFFFFFFFFFFFFFFFFFFFFTFFFW
WFFFFFFFFFFFFWFFFFFFFFFFFFFFFFFFFFFFFFFFFFFFFFFFFFFFFFFFFFFFFFW
WFFFFFFFFFFFFWFFFFFFFFFFFFFFFFFFFFFFFFFFFFFFFFFFFFFFFFFFFFFFFFW
WFFFFFFFFFFFFFFFFFFFFFFFFFFFFFFWWWWWWWWWWWWWWWWWWWWWWWWWWFFFWWW
WFFFFFFFFFFFFFFFFFFFFFFTFFFFFFFWFFFFFFFFFFFFFFFFFFFFFFFFFFFFFFW
WFFFFFFFFFFFFFFFFFFFFFFFFFFFFFFWFFFFFFFFFFFFFFFFFFFFFFFFFFFFFFW
WFFFFFFFFFFFFWFFFFFFFFFFFFFFFFFWFFFFFFFFFFFFFFFFFFFFFFFFFFFFFFW
WFFFFFFFFFFFFWFFFFFFFFFFFFFFFFFWFFFFFFFFFFFFFFFFFFFFFFFFFFFFFFW
WFFFFFFFFFFFFWFFFFFFFFFFFFFFFFFWFFFFFFFFFFFFFFFFFFFFFFFFFFFFFFW
WFFFFFFFFFFFFWFFFFFFFFFFFFFFFFFWFFFFFFFFFFFFFFFFFFFFFFFFFFFFFFW
WFFFFFFFFFFFFWFFFFFFFFFFFFFFFFFWFFFFFFFFFFFFFFFFFFFFFFFFFFFFFFW
WFFFFFFFFFFFFWFFFFFFFFFFFFFFFFFWFFFFFFFFFFFFFFFFFFFFFFFFFFFFFFW
WWWWWWWWWWWWWWWWWWWWWWWWWWWWWWWWWWFFFWWWWWWWWWWWWWWWWWWWWWWWWWW
WFFFFFFFFFFFFFFFFFFFFFFFFFFFFFFFFFFFFFFFFFFFFFFFFFFFFFFFFFFFFFW
WFFFFFFTFFFFFFFFFFFFFFFFFFFFFFFFFFFFFFFFFFFFFFFFFFFFFFFFFFFFFFW
WFFFFFFFFFFFFFFFFFFFFFFFFFFFFFFFFFFFFFFFFFFFFFFFFFFFFFFFFFFFFFW
WWWFFFWWWWWWWWWWWWWWWWWWWWWWWWWWWWWWWWWWWWWWWWWWWWWFFFWWWWWWWWW
WFFFFFFFWFFFFFFFFFFFFFFFFFFFFFFFFFFFFFFFFFFFFFFFFFFFFFFFFFFFFFW
WFFFFFFFWFTFFFFFFFFFFFFFFFFFFFFFFFFFFFFFFFFFFFFFFFFFFFFFFFFFFFW
WFFFFFFFWFFFFFFFFFFFFFFFFFFFFFFFFFFFFFFFFFFFFFFFFFFFFFFFFFFFFFW
WFFFFFFFWFFFFFFFFFFFFFFFFFFFFFFFFFFFFFFFFFFFFFFFFFFFFFFFFFFFFFW
WFFFFFFFWFFFFWWWWWWWWWWWWWWWWWWWWWWWWWWWWWWWWWWWWWWWWWWWWWWWWWW
WFFFFFFFWFFFFFFFFFFFFFFFFFWFFFFFFFFFFFFFFFFFFFFFFFFFFFFFFFFFFFW
WFFFFFFFWFFFFFFFFFFFFFFFFFWFFFFFFFFFFFFFFFFFFFFFFFFFFFFFFFFFTFW
WFFFFFFFWFFFFFFFFFFFFFFFFFWFFFFFFFFFFFFFFFFFFFFFFFFFFFFFFFFFFFW
WFFFFFFFWFFFFFFFFFFFFFFFFFWFFFFFFFFFFFFFFFFFFFFFFFFFFFFFFFFFFFW
WFFFFFFFWFFFFFFFFFFFFFFFFFWFFFFFFFFFFFFFFFFFFFFFFFFFFFFFFFFFFFW
WFFFFFFFWFFFFFFFFFFFFFFFFFWFFFFFFFFFFFFFFFFFFFFFFFFFFFFFFFFFFFW
WFFFFFFFWFFFFFFFFFFFFFFFFFWFFFFFFFFFFFFFFFFFFFFWWWWWWWWWWWWFFFW
WFFFFFFFWFFFFFFFFFFFFFFFFFWFFFFFFFFFFFFFFFFFFFFWFFFFFFFFFFFFFFW
WFFFFFFFWFFFFFFFFFFFFFFFFFWFFFFFFFFFFFFFFFFFFFFWFFFFFFFFFFFFFFW
WFFFFFFFWFFFFFFFFFFFFFFFFFFFFFFFFFFFFFFFFFFFFFFWFFFFFFFFFFFFFFW
WFFFFFFFWFFFFFFFTFFFFFFFFFFFFFFFFFFFFFFFFFFFFFFWFFFFFFFFTFFFFFW
WFFFFFFFWFFFFFFFFFFFFFFFFFFFFFFFFFFFFFFFFFFFFFFWFFFFFFFFFFFFFFW
WFFFFFFFWFFFFFFFFFFFFFFFFFWFFFFFFFFFFFFFFFFFFFFWFFFFFFFFFFFFFFW
WFFFFFFFWWWWWWWWWWWWWWWWWWWWWWWWWWWWWWWWWWWWWWWWFFFWWWWWWWWWWWW
WFFFFFFFFFFFFFFFFFWFFFFFFFFFFFFFFFWFFFFFFFFFFFFFFFFFFFFFFFFFFFW
WFFFFFFFFFFFFFFFFFWFFFFFFFTFFFFFFFWFFFFFFFFFFFFFFFFFFFFFFFFFFFW
WFFFFFFFFFFFFFFFFFWFFFFFFFFFFFFFFFWFFFFTFFFFFFFFFFFFFFFFFFFFFFW
WWWWWFFFFFFFFFFFFFWFFFFFFFFFFFFFFFWFFFFFFFFFFFFFFFFFFFFFFFFFFFW
WFFFFFFFFFFFFFFFFFWFFFFFFFFFFFFFFFWFFFFFFFFFFFFFFFFFFFFFFFFFFFW
WFFFFFFFFFFFFWWWWWWFFFFFFFFFFFFFFFWFFFFFFFFFFFFFFFFFFFFFFFFFFFW
WFFFFFFFFFFFFFFFFFWFFFFFFFFFFFFFFFWFFFFFFFFFFFFFFFFFFFFFFFFFFFW
WFFFFFFWWWWWFFFFFFWFFFFFFFFFFFFFFFWFFFFFFFFFFFFFFFFFFFFFFFFFFFW
WFFFFFFWWWWWFFFFFFWFFFFFFFFFFFFFFFWFFFFFFFFFFFFFFFFFFFFFFFFFFFW
WFFFFFFWWWWWFFFFFFWFFFFFFFFFFFFFFFWFFWFFFFFFFFFFFFFFFWFFFFFFFFW
WFFFFFFWWWWWFFFFFFWFFFFFFFFFFFFFFFWFFFWFFFFFFFFFFFFFWFFFFFFFFFW
WFFFFF0FF1FFFFFFFFFFFFFFWWWFFFFFFFFFFFFWFFFFFFFFFFFWFFFFFFFFFFW
WFFFFFFFFFFFFFFFFFFFFFFFWWWFFFFFFFFFFFFFWFFFFFFFFFWFFFFFFFFFFFW
WFFFFFFFSFFFFFFFFFFFFFFFWWWFFFFFFFFFFFFFFWFFFFFFFWFFFFFFFFFFFFW
WFFFFFFFFFFFFFFTFFWFFFFFFFFFFFFFFFWFFFFFFFWFFFFFWFFFFFFFFFFFFFW
WFFFFFFFFFFFFFFFFFWFFFFFFFFFFFFFFFWFFFFFFFFWFFFWFFFFFFFFFFFFFFW
WWWWFFFWWWWWWWWWWWWWWWWWWWWWWWWWWWWFFFFFFFFWFFFWFFFFFFFFFFFFFFW
WFFFFFFFFFWFFFFFFFFFFFFFFFFFFFFFFFFFFFFFFFWFFFFFWFFFFFFFFFFFFFW
WFFFFFFFFFWFFFFFFFFFFFFFFFFFFFFFFFFFFFFFFWFFFFFFFWFFFFFFFFFFFFW
WFFFFFFFFFWFFFFFFFFWFFFFFFFFFFFFFFFFFFFFWFFFFFFFFFWFFFFFFFFFFFW
WFFFFFFFFFWFFFFSFFFWFFFFFFFFFFFFFFFFFFFWFFFFFFFFFFFWFFFFFFFFFFW
WFFFFFFFFFWFFFFFFFFWFFFFFFWWWWWFFFFFFFWFFFFFFFFFFFFFWFFFFFFFFFW
WFFFFPFFFFFFFFFFFFFWFFFFFFFFFFFFFFFFFWFFFFFFFFFFFFFFFWFFFFFFFFW
WFFFFFFFFFFFFFFFFFFWFFFFFFFFFFFFFFFFFFFFFFFFFFFFFFFFFFFFFFFFFFW
WWWWWWWWWWWWWWWWWWWWWWWWWWWWWWWWWWWWWWWWWWWWWWWWWWWWWWWWWWWWWWW
